a	- a
ah	- ah
ai	- ai
ak	- ak
am	- am
an	- an
ang	- ang
ann	- ann
ap	- ap
at	- at
au	- au
ba	b- a
bah	b- ah
bai	b- ai
bak	b- ak
ban	b- an
bang	b- ang
bann	b- ann
bat	b- at
bau	b- au
bauh	b- auh
be	b- e
beh	b- eh
bei	b- ei
ben	b- en
benn	b- enn
ber	b- er
berh	b- erh
bern	b- ern
bet	b- et
bha	bh- a
bhah	bh- ah
bhai	bh- ai
bhak	bh- ak
bhan	bh- an
bhang	bh- ang
bhat	bh- at
bhau	bh- au
bhe	bh- e
bheh	bh- eh
bhen	bh- en
bher	bh- er
bherh	bh- erh
bhet	bh- et
bhi	bh- i
bhiau	bh- iau
bhier	bh- ier
bhih	bh- ih
bhik	bh- ik
bhin	bh- in
bhing	bh- ing
bhio	bh- io
bhit	bh- it
bhiu	bh- iu
bhng	bh- ng
bho	bh- o
bhoh	bh- oh
bhok	bh- ok
bhon	bh- on
bhong	bh- ong
bhu	bh- u
bhua	bh- ua
bhuah	bh- uah
bhuan	bh- uan
bhuat	bh- uat
bhue	bh- ue
bhueh	bh- ueh
bhui	bh- ui
bhuk	bh- uk
bhun	bh- un
bhut	bh- ut
bi	b- i
bia	b- ia
biah	b- iah
biak	b- iak
biang	b- iang
biann	b- iann
biau	b- iau
bie	b- ie
bien	b- ien
bier	b- ier
bierh	b- ierh
biet	b- iet
bih	b- ih
bik	b- ik
bin	b- in
bing	b- ing
binn	b- inn
bio	b- io
bit	b- it
biu	b- iu
bng	b- ng
bo	b- o
boh	b- oh
bok	b- ok
bong	b- ong
bot	b- ot
bu	b- u
bua	b- ua
buah	b- uah
buan	b- uan
buann	b- uann
buat	b- uat
bue	b- ue
bueh	b- ueh
buh	b- uh
bui	b- ui
buinn	b- uinn
buk	b- uk
bun	b- un
buo	b- uo
but	b- ut
ca	c- a
cah	c- ah
cai	c- ai
cak	c- ak
cam	c- am
can	c- an
cang	c- ang
cap	c- ap
cat	c- at
cau	c- au
ce	c- e
ceh	c- eh
cen	c- en
cenn	c- enn
cer	c- er
cern	c- ern
cet	c- et
ci	c- i
cia	c- ia
ciah	c- iah
ciak	c- iak
ciam	c- iam
cian	c- ian
ciang	c- iang
ciann	c- iann
ciap	c- iap
ciau	c- iau
cien	c- ien
cier	c- ier
cierh	c- ierh
ciet	c- iet
cih	c- ih
cii	c- ii
cik	c- ik
cim	c- im
cin	c- in
cing	c- ing
cinn	c- inn
cio	c- io
ciok	c- iok
ciong	c- iong
cionn	c- ionn
ciou	c- iou
cip	c- ip
cit	c- it
ciu	c- iu
ciunn	c- iunn
cng	c- ng
co	c- o
cok	c- ok
cong	c- ong
cop	c- op
cot	c- ot
cu	c- u
cua	c- ua
cuah	c- uah
cuai	c- uai
cuainn	c- uainn
cuan	c- uan
cuann	c- uann
cue	c- ue
cueh	c- ueh
cuei	c- uei
cuh	c- uh
cui	c- ui
cuk	c- uk
cun	c- un
cung	c- ung
cut	c- ut
cyu	cy- u
cyuet	cy- uet
da	d- a
dah	d- ah
dai	d- ai
daih	d- aih
dak	d- ak
dam	d- am
dan	d- an
dang	d- ang
dann	d- ann
dap	d- ap
dat	d- at
dau	d- au
dauh	d- auh
de	d- e
deh	d- eh
dei	d- ei
dem	d- em
den	d- en
denn	d- enn
der	d- er
derh	d- erh
dern	d- ern
det	d- et
di	d- i
dia	d- ia
diah	d- iah
diak	d- iak
diam	d- iam
diang	d- iang
diann	d- iann
diap	d- iap
diau	d- iau
diauh	d- iauh
die	d- ie
dien	d- ien
dier	d- ier
dierh	d- ierh
diet	d- iet
dih	d- ih
dik	d- ik
dim	d- im
din	d- in
ding	d- ing
dinn	d- inn
dinnh	d- innh
dio	d- io
dioh	d- ioh
diok	d- iok
diong	d- iong
dionn	d- ionn
diou	d- iou
dip	d- ip
dit	d- it
diu	d- iu
diuh	d- iuh
diunn	d- iunn
dng	d- ng
do	d- o
doh	d- oh
dok	d- ok
dom	d- om
don	d- on
dong	d- ong
dot	d- ot
dou	d- ou
du	d- u
dua	d- ua
duah	d- uah
duainn	d- uainn
duan	d- uan
duann	d- uann
duat	d- uat
due	d- ue
dueh	d- ueh
duh	d- uh
dui	d- ui
duinn	d- uinn
dun	d- un
dung	d- ung
duo	d- uo
dut	d- ut
e	- e
eh	- eh
ei	- ei
em	- em
en	- en
enn	- enn
er	- er
erh	- erh
ern	- ern
et	- et
fa	f- a
fan	f- an
fang	f- ang
fat	f- at
fi	f- i
fo	f- o
fok	f- ok
fong	f- ong
fu	f- u
fut	f- ut
ga	g- a
gah	g- ah
gai	g- ai
gak	g- ak
gam	g- am
gan	g- an
gang	g- ang
gann	g- ann
gap	g- ap
gat	g- at
gau	g- au
gauh	g- auh
ge	g- e
geh	g- eh
gei	g- ei
gen	g- en
genn	g- enn
ger	g- er
gerh	g- erh
gern	g- ern
get	g- et
gha	gh- a
ghah	gh- ah
ghai	gh- ai
ghak	gh- ak
gham	gh- am
ghan	gh- an
ghang	gh- ang
ghap	gh- ap
ghat	gh- at
ghau	gh- au
ghe	gh- e
gheh	gh- eh
ghen	gh- en
gher	gh- er
ghet	gh- et
ghi	gh- i
ghia	gh- ia
ghiah	gh- iah
ghiak	gh- iak
ghiam	gh- iam
ghian	gh- ian
ghiang	gh- iang
ghiap	gh- iap
ghiau	gh- iau
ghier	gh- ier
ghierh	gh- ierh
ghih	gh- ih
ghik	gh- ik
ghim	gh- im
ghin	gh- in
ghing	gh- ing
ghiok	gh- iok
ghiong	gh- iong
ghip	gh- ip
ghit	gh- it
ghiu	gh- iu
gho	gh- o
ghok	gh- ok
ghong	gh- ong
ghu	gh- u
ghua	gh- ua
ghuai	gh- uai
ghuan	gh- uan
ghuat	gh- uat
ghue	gh- ue
ghueh	gh- ueh
ghui	gh- ui
ghun	gh- un
ghut	gh- ut
gi	g- i
gia	g- ia
giah	g- iah
giak	g- iak
giam	g- iam
gian	g- ian
giang	g- iang
giann	g- iann
giap	g- iap
giau	g- iau
gie	g- ie
gien	g- ien
gier	g- ier
gierh	g- ierh
gih	g- ih
gik	g- ik
gim	g- im
gin	g- in
ging	g- ing
ginn	g- inn
gio	g- io
giok	g- iok
giong	g- iong
gionn	g- ionn
gip	g- ip
git	g- it
giu	g- iu
giung	g- iung
giunn	g- iunn
gng	g- ng
go	g- o
goh	g- oh
gok	g- ok
gong	g- ong
got	g- ot
gu	g- u
gua	g- ua
guah	g- uah
guai	g- uai
guainn	g- uainn
guak	g- uak
guan	g- uan
guang	g- uang
guann	g- uann
guat	g- uat
gue	g- ue
gueh	g- ueh
guh	g- uh
gui	g- ui
guinn	g- uinn
gun	g- un
gung	g- ung
guo	g- uo
gut	g- ut
ha	h- a
hah	h- ah
hai	h- ai
hainn	h- ainn
hak	h- ak
ham	h- am
han	h- an
hang	h- ang
hann	h- ann
hannh	h- annh
hap	h- ap
hat	h- at
hau	h- au
hauh	h- auh
he	h- e
heh	h- eh
hei	h- ei
hem	h- em
hen	h- en
henn	h- enn
hennh	h- ennh
her	h- er
herh	h- erh
hernn	h- ernn
het	h- et
hi	h- i
hia	h- ia
hiah	h- iah
hiak	h- iak
hiam	h- iam
hiang	h- iang
hiann	h- iann
hiannh	h- iannh
hiap	h- iap
hiau	h- iau
hier	h- ier
hierh	h- ierh
hik	h- ik
him	h- im
hin	h- in
hing	h- ing
hinn	h- inn
hio	h- io
hiok	h- iok
hiong	h- iong
hionn	h- ionn
hip	h- ip
hit	h- it
hiu	h- iu
hiuk	h- iuk
hiun	h- iun
hiung	h- iung
hiunn	h- iunn
hm	h- m
hng	h- ng
ho	h- o
hoh	h- oh
hok	h- ok
hong	h- ong
honn	h- onn
hop	h- op
hot	h- ot
hu	h- u
hua	h- ua
huah	h- uah
huai	h- uai
huainn	h- uainn
huan	h- uan
huann	h- uann
huat	h- uat
hue	h- ue
hueh	h- ueh
huenn	h- uenn
huh	h- uh
hui	h- ui
huih	h- uih
huinn	h- uinn
hun	h- un
hut	h- ut
i	- i
ia	- ia
iah	- iah
iak	- iak
iam	- iam
ian	- ian
iang	- iang
iann	- iann
iap	- iap
iau	- iau
ie	- ie
ien	- ien
ier	- ier
ierh	- ierh
iet	- iet
ih	- ih
ik	- ik
im	- im
in	- in
ing	- ing
inn	- inn
io	- io
ioh	- ioh
iok	- iok
iong	- iong
ionn	- ionn
iou	- iou
ip	- ip
it	- it
iu	- iu
iunn	- iunn
ka	k- a
kah	k- ah
kai	k- ai
kak	k- ak
kam	k- am
kan	k- an
kang	k- ang
kann	k- ann
kap	k- ap
kat	k- at
kau	k- au
ke	k- e
keh	k- eh
ken	k- en
kenn	k- enn
kennh	k- ennh
ker	k- er
kerh	k- erh
kern	k- ern
ket	k- et
ki	k- i
kia	k- ia
kiah	k- iah
kiak	k- iak
kiam	k- iam
kian	k- ian
kiang	k- iang
kiann	k- iann
kiap	k- iap
kiau	k- iau
kie	k- ie
kien	k- ien
kier	k- ier
kierh	k- ierh
kiet	k- iet
kih	k- ih
kik	k- ik
kim	k- im
kin	k- in
king	k- ing
kinn	k- inn
kio	k- io
kioh	k- ioh
kiok	k- iok
kiong	k- iong
kip	k- ip
kit	k- it
kiu	k- iu
kiung	k- iung
kiunn	k- iunn
kiut	k- iut
kng	k- ng
ko	k- o
kok	k- ok
kong	k- ong
konn	k- onn
ku	k- u
kua	k- ua
kuah	k- uah
kuai	k- uai
kuan	k- uan
kuang	k- uang
kuann	k- uann
kuat	k- uat
kue	k- ue
kueh	k- ueh
kuei	k- uei
kuh	k- uh
kui	k- ui
kuinn	k- uinn
kun	k- un
kung	k- ung
kut	k- ut
la	l- a
lah	l- ah
lai	l- ai
laih	l- aih
lak	l- ak
lam	l- am
lan	l- an
lang	l- ang
lap	l- ap
lat	l- at
lau	l- au
le	l- e
leh	l- eh
len	l- en
ler	l- er
lerh	l- erh
let	l- et
li	l- i
lia	l- ia
liah	l- iah
liak	l- iak
liam	l- iam
liang	l- iang
liap	l- iap
liau	l- iau
liauh	l- iauh
lien	l- ien
lier	l- ier
lierh	l- ierh
liet	l- iet
lih	l- ih
lik	l- ik
lim	l- im
lin	l- in
ling	l- ing
lio	l- io
liok	l- iok
liong	l- iong
liou	l- iou
lip	l- ip
lit	l- it
liu	l- iu
liuh	l- iuh
lng	l- ng
lo	l- o
loh	l- oh
lok	l- ok
long	l- ong
lop	l- op
lot	l- ot
lu	l- u
lua	l- ua
luah	l- uah
luan	l- uan
lue	l- ue
lueh	l- ueh
luh	l- uh
lui	l- ui
luk	l- uk
lun	l- un
luo	l- uo
lut	l- ut
m	- m
ma	m- a
mah	m- ah
mai	m- ai
man	m- an
mang	m- ang
mau	m- au
me	m- e
meh	m- eh
mei	m- ei
men	m- en
mer	m- er
mern	m- ern
mi	m- i
mia	m- ia
miau	m- iau
mie	m- ie
mih	m- ih
min	m- in
ming	m- ing
mio	m- io
miou	m- iou
miu	m- iu
mng	m- ng
mo	m- o
moh	m- oh
mong	m- ong
mou	m- ou
mu	m- u
mua	m- ua
muah	m- uah
muai	m- uai
muan	m- uan
mue	m- ue
mui	m- ui
mun	m- un
muo	m- uo
n	- n
na	n- a
nah	n- ah
nai	n- ai
nam	n- am
nan	n- an
nang	n- ang
nap	n- ap
nau	n- au
ne	n- e
neh	n- eh
nei	n- ei
nen	n- en
ner	n- er
ng	- ng
nga	ng- a
ngai	ng- ai
ngaih	ng- aih
ngau	ng- au
nge	ng- e
ngeh	ng- eh
nger	ng- er
ngi	ng- i
ngia	ng- ia
ngiau	ng- iau
ngin	ng- in
ngio	ng- io
ngo	ng- o
ngoh	ng- oh
ngong	ng- ong
ngu	ng- u
ngua	ng- ua
ngueh	ng- ueh
ni	n- i
nia	n- ia
niah	n- iah
niam	n- iam
niang	n- iang
niau	n- iau
nie	n- ie
nih	n- ih
nim	n- im
nin	n- in
ning	n- ing
nio	n- io
niou	n- iou
niu	n- iu
niunn	n- iunn
nng	n- ng
no	n- o
nong	n- ong
nu	n- u
nua	n- ua
nuan	n- uan
nui	n- ui
nuo	n- uo
o	- o
oh	- oh
ok	- ok
om	- om
ong	- ong
onn	- onn
ot	- ot
ou	- ou
pa	p- a
pah	p- ah
pai	p- ai
painn	p- ainn
pak	p- ak
pan	p- an
pang	p- ang
pann	p- ann
pat	p- at
pau	p- au
pe	p- e
peh	p- eh
pen	p- en
penn	p- enn
per	p- er
perh	p- erh
pern	p- ern
pet	p- et
pi	p- i
pia	p- ia
piah	p- iah
piak	p- iak
piang	p- iang
piann	p- iann
piau	p- iau
pien	p- ien
pier	p- ier
pih	p- ih
pik	p- ik
pin	p- in
ping	p- ing
pinn	p- inn
pio	p- io
piok	p- iok
pit	p- it
piu	p- iu
png	p- ng
po	p- o
poh	p- oh
pok	p- ok
pon	p- on
pong	p- ong
pu	p- u
pua	p- ua
puah	p- uah
puan	p- uan
puann	p- uann
puat	p- uat
pue	p- ue
puh	p- uh
pui	p- ui
pun	p- un
put	p- ut
ran	r- an
rang	r- ang
rau	r- au
re	r- e
reh	r- eh
ren	r- en
ret	r- et
rha	rh- a
rhat	rh- at
rhe	rh- e
rher	rh- er
rhit	rh- it
rhou	rh- ou
rhui	rh- ui
ri	r- i
ria	r- ia
riah	r- iah
riak	r- iak
riam	r- iam
riang	r- iang
riap	r- iap
riau	r- iau
rier	r- ier
rih	r- ih
rik	r- ik
rim	r- im
rin	r- in
ring	r- ing
riok	r- iok
riong	r- iong
rip	r- ip
rit	r- it
riu	r- iu
rok	r- ok
ru	r- u
rua	r- ua
ruah	r- uah
ruan	r- uan
rue	r- ue
rueh	r- ueh
rui	r- ui
run	r- un
rut	r- ut
sa	s- a
sah	s- ah
sai	s- ai
sainn	s- ainn
sak	s- ak
sam	s- am
san	s- an
sang	s- ang
sann	s- ann
sannh	s- annh
sap	s- ap
sat	s- at
sau	s- au
se	s- e
seh	s- eh
sei	s- ei
sem	s- em
sen	s- en
senn	s- enn
ser	s- er
serh	s- erh
sern	s- ern
set	s- et
si	s- i
sia	s- ia
siah	s- iah
siak	s- iak
siam	s- iam
siang	s- iang
siann	s- iann
siap	s- iap
siau	s- iau
sie	s- ie
sien	s- ien
sier	s- ier
sierh	s- ierh
siet	s- iet
sih	s- ih
sii	s- ii
sik	s- ik
sim	s- im
sin	s- in
sing	s- ing
sinn	s- inn
sio	s- io
sioh	s- ioh
siok	s- iok
siong	s- iong
sionn	s- ionn
siou	s- iou
sip	s- ip
sit	s- it
siu	s- iu
siuh	s- iuh
siunn	s- iunn
siut	s- iut
sng	s- ng
so	s- o
soh	s- oh
sok	s- ok
som	s- om
son	s- on
song	s- ong
sop	s- op
sot	s- ot
sou	s- ou
su	s- u
sua	s- ua
suah	s- uah
suai	s- uai
suainn	s- uainn
suan	s- uan
suann	s- uann
suat	s- uat
sue	s- ue
sueh	s- ueh
suei	s- uei
suh	s- uh
sui	s- ui
suinn	s- uinn
sun	s- un
sung	s- ung
suo	s- uo
sut	s- ut
syun	sy- un
ta	t- a
tah	t- ah
tai	t- ai
tak	t- ak
tam	t- am
tan	t- an
tang	t- ang
tann	t- ann
tap	t- ap
tat	t- at
tau	t- au
te	t- e
teh	t- eh
ten	t- en
tenn	t- enn
ter	t- er
terh	t- erh
tet	t- et
ti	t- i
tia	t- ia
tiah	t- iah
tiak	t- iak
tiam	t- iam
tiang	t- iang
tiann	t- iann
tiannh	t- iannh
tiap	t- iap
tiau	t- iau
tien	t- ien
tier	t- ier
tiet	t- iet
tih	t- ih
tik	t- ik
tim	t- im
tin	t- in
ting	t- ing
tinn	t- inn
tio	t- io
tiok	t- iok
tiong	t- iong
tit	t- it
tiu	t- iu
tng	t- ng
to	t- o
tok	t- ok
tong	t- ong
tot	t- ot
tu	t- u
tua	t- ua
tuah	t- uah
tuan	t- uan
tuann	t- uann
tuat	t- uat
tue	t- ue
tuei	t- uei
tuh	t- uh
tui	t- ui
tuinn	t- uinn
tun	t- un
tut	t- ut
u	- u
ua	- ua
uah	- uah
uai	- uai
uainn	- uainn
uan	- uan
uang	- uang
uann	- uann
uat	- uat
ue	- ue
ueh	- ueh
uei	- uei
uh	- uh
ui	- ui
uih	- uih
uinn	- uinn
un	- un
ung	- ung
unn	- unn
uo	- uo
ut	- ut
vet	v- et
ya	y- a
yi	y- i
yu	y- u
yuan	y- uan
yue	y- ue
yun	y- un
yung	y- ung
za	z- a
zah	z- ah
zai	z- ai
zainn	z- ainn
zak	z- ak
zam	z- am
zan	z- an
zang	z- ang
zann	z- ann
zap	z- ap
zat	z- at
zau	z- au
zauh	z- auh
ze	z- e
zeh	z- eh
zei	z- ei
zem	z- em
zen	z- en
zenn	z- enn
zer	z- er
zerh	z- erh
zern	z- ern
zet	z- et
zi	z- i
zia	z- ia
ziah	z- iah
ziak	z- iak
ziam	z- iam
zian	z- ian
ziang	z- iang
ziann	z- iann
ziap	z- iap
ziau	z- iau
zie	z- ie
zien	z- ien
zier	z- ier
zierh	z- ierh
ziet	z- iet
zih	z- ih
zii	z- ii
zik	z- ik
zim	z- im
zin	z- in
zing	z- ing
zinn	z- inn
zio	z- io
zioh	z- ioh
ziok	z- iok
ziong	z- iong
zionn	z- ionn
ziot	z- iot
ziou	z- iou
zip	z- ip
zit	z- it
ziu	z- iu
ziung	z- iung
ziunn	z- iunn
zng	z- ng
zo	z- o
zoh	z- oh
zok	z- ok
zom	z- om
zong	z- ong
zot	z- ot
zou	z- ou
zu	z- u
zua	z- ua
zuah	z- uah
zuai	z- uai
zuainn	z- uainn
zuan	z- uan
zuann	z- uann
zuat	z- uat
zue	z- ue
zueh	z- ueh
zuh	z- uh
zui	z- ui
zuinn	z- uinn
zuk	z- uk
zun	z- un
zuo	z- uo
zut	z- ut
zyu	zy- u
